9
11
45
###########
#....B....#
#..s......#
#....B.b..#
#..s.@....#
#....S.b..#
#.........#
#....S....#
###########
